3 0 0 0 8
3 0 0 1	8
3 0 1 0 8
3 0 1 1 8
3 0 2 0 8
3 0 2 1 8
3 0 3 0 8
3 0 3 1 8
3 0 4 2 8
3 0 4 3 8
3 0 4 4 8
3 0 5 2 8
3 0 5 3 8
3 0 5 4 8
3 0 6 2 8
3 0 6 3 8
3 0 6 4 8
3 0 7 2 8
3 1 7 3 8
3 1 7 4 8
3 1 8 2 8
3 1 8 3 8
3 1 8 4 8
3 1 0 0 9
3 1 0 1	9
3 1 1 0 9
3 1 1 1 9
3 1 2 0 9
3 1 2 1 9
3 1 3 0 9
3 1 3 1 9
3 1 4 2 9
3 1 4 3 9
3 1 4 4 9
3 1 5 2 9
3 1 5 3 9
7 0 6 3 13
7 0 6 4 13
7 0 7 2 13
7 0 7 3 13
7 0 7 4 13
7 0 8 2 13
7 0 8 3 13
7 0 8 4 13
7 0 0 0 14
7 0 0 1 14
7 1 1 0 14
7 1 1 1 14
7 1 2 0 14
7 1 2 1 14
7 1 3 0 14
7 1 3 1 14
7 1 4 2 14
7 1 4 3 14
7 1 4 4 14
7 1 5 2 14
