9 0 0 0 8
9 0 0 1	8
9 0 1 0 8
9 0 1 1 8
9 0 2 0 8
9 0 2 1 8
9 0 3 0 8
9 0 3 1 8
9 0 4 2 8
9 0 4 3 8
9 0 4 4 8
9 0 5 2 8
9 0 5 3 8
9 0 5 4 8
9 0 6 2 8
9 0 6 3 8
9 0 6 4 8
9 0 7 2 8
9 0 7 3 8
9 0 7 4 8
9 1 8 2 8
9 1 8 3 8
9 1 8 4 8
9 1 0 0 9
9 1 0 1	9
9 1 1 0 9
9 1 1 1 9
9 1 2 0 9
9 1 2 1 9
9 1 3 0 9
9 1 3 1 9
9 1 4 2 9
9 1 4 3 9
9 1 4 4 9
9 1 5 2 9
9 1 5 3 9
9 1 5 4 9
9 1 6 2 9
9 1 6 3 9
9 1 6 4 9